XXXXXXXXXXXXXXXXXXXXXXXXXXXXE
XPCCCCCCCCCCCXXCCCCCCCCCCCCXE
XCXXXXCXXXXXCXXCXXXXXCXXXXCXE
XCXXXXCXXXXXCXXCXXXXXCXXXXCXE
XCXXXXCXXXXXCXXCXXXXXCXXXXCXE
XCCCCCCCCCCCCCBCCCCCCCCCCCCXE
XCXXXXCXXCXXXXXXXXCXXCXXXXCXE
XCXXXXCXXCXXXXXXXXCXXCXXXXCXE
XCCCCCCXXCCCCXXCCCCXXCCCCCCXE
XXXXXXCXXXXX XX XXXXXCXXXXXXE
     XCXX          XXCX     E
     XCXX XXXXXXXX XXCX     E
XXXXXXCXX X      X XXCXXXXXXE
      B   X      X   B      E
XXXXXXCXX X      X XXCXXXXXXE
     XCXX XXXXXXXX XXCX     E
     XCXX          XXCX     E
XXXXXXCXX XXXXXXXX XXCXXXXXXE
XCCCCCCCCCCCCXXCCCCCCCCCCCCXE
XCXXXXCXXXXXCXXCXXXXXCXXXXCXE
XCXXXXCXXXXXCXXCXXXXXCXXXXCXE
XCCCXXCCCCCCCCCCCCCCCCXXCCCXE
XXXCXXCXXCXXXXXXXXCXXCXXCXXXE
XCCCCCCXXCCCCXXCCCCXXCCCCCCXE
XCXXXXXXXXXXCXXCXXXXXXXXXXCXE
XCXXXXXXXXXXCXXCXXXXXXXXXXCXE
XCCCCCCCCCCCCBCCCCCCCCCCCCCXE
XXXXXXXXXXXXXXXXXXXXXXXXXXXXE
